s_m_belet.X	b_m.x
s_m_bs.X	b_m.x
s_m_cos_bl.X	b_m.x
s_m_cos_cj01.X	b_m.x
s_m_cos_cj02.X	b_m.x
s_m_cos_cj03.X	b_m.x
s_m_cos_cr.X	b_m.x
s_m_cos_gls.X	b_m.x
s_m_cos_gm.X	b_m.x
s_m_cos_hg.X	b_m.x
s_m_cos_jj.X	b_m.x
s_m_cos_kg.X	b_m.x
s_m_cos_kr.X	b_m.x
s_m_cos_ml.X	b_m.x
s_m_cos_nj.X	b_m.x
s_m_cos_shair.X	b_m.x
s_m_cos_sm.X	b_m.x
s_m_cos_sn.X	b_m.x
s_m_cos_tx.X	b_m.x
s_m_db.X	b_m.x
s_m_face.X	b_m.x
s_m_f_bs.X	b_m.x
s_m_f_cc.X	b_m.x
s_m_f_gc.X	b_m.x
s_m_f_gg.X	b_m.x
s_m_f_gl.X	b_m.x
s_m_f_kg.X	b_m.x
s_m_f_zt.X	b_m.x
s_m_gloves.X	b_m.x
s_m_gongyong.X	b_m.x
s_m_gum.X	b_m.x
s_m_hb.X	b_m.x
s_m_jipang.X	b_m.x
s_m_jp_gothic.X	b_m.x
s_m_kbs.X	b_m.x
s_m_kdb.X	b_m.x
s_m_khb.X	b_m.x
s_m_k_bs.X	b_m.x
s_m_k_cc.X	b_m.x
s_m_k_gc.X	b_m.x
s_m_k_gg.X	b_m.x
s_m_k_gl.X	b_m.x
s_m_k_kg.X	b_m.x
s_m_k_zt.X	b_m.x
s_m_whal.X	b_m.x
s_m_wkb.X	b_m.x
	
s_w_a_bs.X	b_w.x
s_w_a_cc.X	b_w.x
s_w_a_gc.X	b_w.x
s_w_a_gg.X	b_w.x
s_w_a_gl.X	b_w.x
s_w_a_kg.X	b_w.x
s_w_a_zt.X	b_w.x
s_w_belet.X	b_w.x
s_w_bs.X	b_w.x
s_w_cos_bl.X	b_w.x
s_w_cos_cj01.X	b_w.x
s_w_cos_cj02.X	b_w.x
s_w_cos_cj03.X	b_w.x
s_w_cos_gls.X	b_w.x
s_w_cos_gm.X	b_w.x
s_w_cos_hg.X	b_w.x
s_w_cos_jj.X	b_w.x
s_w_cos_nj.X	b_w.x
s_w_cos_nu.X	b_w.x
s_w_cos_rg.X	b_w.x
s_w_cos_rg02.X	b_w.x
s_w_cos_shair.X	b_w.x
s_w_cos_sm.X	b_w.x
s_w_cos_sn.X	b_w.x
s_w_cos_st.X	b_w.x
s_w_cos_tr.X	b_w.x
s_w_cos_tx.X	b_w.x
s_w_db.X	b_w.x
s_w_face.X	b_w.x
s_w_gloves.X	b_w.x
s_w_gongyong.X	b_w.x
s_w_gum.X	b_w.x
s_w_hb.X	b_w.x
s_w_jipang.X	b_w.x
s_w_jp_maid.X	b_w.x
s_w_kdb.X	b_w.x
s_w_khb.X	b_w.x
s_w_s_bs.X	b_w.x
s_w_s_cc.X	b_w.x
s_w_s_gc.X	b_w.x
s_w_s_gg.X	b_w.x
s_w_s_gl.X	b_w.x
s_w_s_kg.X	b_w.x
s_w_s_zt.X	b_w.x
s_w_whal.X	b_w.x
s_w_wkb.X	b_w.x